111111111111111111111111111111111111111111111111
1C000111111C000000000000000111111111110000C00011
100000011111000000000000000000011111110000000001
100000001110000000000000000000000111000000000001
10000000001000000000000000000000001C000000000001
10000000000000000000000000000C000000000000000001
100000000000000000000000000000000000000000000001
100000000010000000100011111111100000000000000001
10000000001000C000100000000000100000000000000001
100000000010000000100000000000100000000000000001
1000000000100000001000000C0000100000000000000001
10000000001000000C100000000000100000000000000001
100000C0001111111110C011111111100000000000000001
100000000000000000100010000000000000000000000001
100001000000000000100010000C00000000000000000001
1C0111000E00000000100010000000000000000000000001
111100000000000000100010000000000000000000000001
111000000000000000100011111111100000000000000011
110000000000000000000000000000000000000000000001
10000000000C000000000000000000000000000000000001
1000000000000000000000000000000000000C0000000001
10000000000000000000000C00000P000000000000000001
10000000C0000000000000000000000000000000C0000001
100000000000000000C00000000110000000000000000001
111111111111111111111111111111111111111111111111
